##########
#..G....G#
#.####.###
#...#....#
#..@.....#
#..##..G.#
#..G#..D.#
#..####..#
#........#
##########
