##########
#........#
#.###.##.#
#.#@#.##.#
#...#....#
##.##.####
#..G#..D.#
#..####..#
#........#
##########